%%%%%%%%%%%%%%%%%%%%%%%
%       %     %     % %
%%% % %%%%% % %%% % % %
% % %       %   % %   %
% % % %%%%% %%% % %%% %
%   % %   %         % %
% %%% % % % % % %%%%% %
% %%% % % % % % %%%%% %
% %.% % % % %       % %
% % % %%% %%%%% % %%% %
%P  %         % %     %
%%%%%%%%%%%%%%%%%%%%%%%