%%%%%%%%%%%%%%%%%%%%%%%
%       %     %     %.%
%%% % %%%%% % %%% % % %
% % %       %   % %   %
% % % %%%%% %%% % %%% %
%   % %   %         % %
% % % % % % % % %%%%% %
% % % % % % % % %%%%% %
% % % % % % %       % %
% % % %%% %%%%% % %%% %
%P  %         % %     %
%%%%%%%%%%%%%%%%%%%%%%%