%%%%%%%%%%%%%%%%%%%%%
%.% ... %  ...    ..%
%.%.%%% %P%%%%%%%.%%%
%. . .     .%..   ..%
%%%%%%%%%%%%%%%%%%%%%